22
8
______________________
__##__##__|#__##__##__
__##__|#__#|__##__|#__
__##__##__##__#|__##__
__|#__##__##__##__##__
______________________
____@____________@____
__*___*________*___*__